10
10
# # # # # # # # # #
# 5 5 . . . . 3 3 #
# 5 . . - - - - - #
# . . - - - - - - #
# . . 5 - - - - - #
# + + + . + 5 . . #
# + + + . + + . . #
# + + + . + . . 5 #
# 3 3 . . . . 5 5 #
# # # # # # # # # #
